---#--###--#-
-#---#----##-
####-#-#-#-##
---#---#-#---
-#-####---##-
-#------#----@
-############
-------------#